2 2 2 2 2 2 2 2 2 2 2 2 2 2 2 2 4 4 4 4 4 4 4 4 4 2 2 2 2 2 2 2 2 2 2 2 2 2 2 2 2 2 2 2 2 2 2 2 2 2
2 2 2 2 2 2 5 5 5 5 5 5 5 5 5 5 5 4 4 4 4 4 4 4 4 5 2 2 2 2 2 2 2 2 2 2 2 2 2 2 2 2 2 2 5 5 5 5 5 2
2 2 2 2 2 7 5 5 5 5 0 0 0 0 0 0 0 4 4 4 5 5 0 0 0 4 2 2 2 2 2 2 2 2 2 2 2 2 2 2 2 2 2 5 5 5 5 5 5 2
2 2 2 7 7 5 5 5 5 0 0 0 0 0 0 0 4 4 4 4 5 5 0 0 0 4 2 2 2 2 2 2 2 2 2 2 2 2 2 2 2 2 2 5 5 5 5 5 5 2
2 2 2 5 5 5 5 5 0 0 0 0 0 0 0 4 4 4 4 4 5 5 0 4 0 4 4 4 2 2 2 2 2 2 5 5 5 2 2 2 2 2 5 5 5 5 5 5 5 2
2 2 5 5 5 5 0 0 0 0 0 0 0 0 0 5 5 5 5 5 5 5 4 4 0 0 0 0 0 2 2 2 2 2 4 4 5 2 2 2 2 0 0 0 0 0 0 0 5 2
2 2 2 5 5 0 0 0 0 0 0 0 0 0 0 5 5 5 5 5 5 5 4 4 3 0 0 0 0 0 5 5 0 0 0 4 0 2 6 0 0 0 0 0 0 0 0 0 5 2
2 2 5 5 0 0 0 0 0 0 0 0 0 0 4 4 4 4 5 5 4 4 4 4 3 0 0 0 0 0 5 5 0 0 0 4 0 2 2 6 6 0 0 0 0 0 0 0 5 2
2 2 5 5 4 0 4 0 0 0 0 0 0 4 4 4 4 0 5 5 0 4 4 4 3 3 3 0 0 0 5 5 0 0 0 6 6 2 2 2 2 0 0 0 0 0 0 0 5 2
2 2 5 5 1 0 1 4 4 4 4 4 4 4 4 4 4 4 5 5 4 4 4 4 4 3 3 0 0 0 5 5 0 0 0 2 2 2 2 2 2 0 0 0 0 0 0 0 0 4
1 1 1 1 1 8 1 1 1 1 1 1 4 4 4 4 4 0 5 5 0 4 4 4 4 4 3 0 0 0 5 5 0 0 0 2 2 2 2 2 0 0 0 0 0 0 0 0 0 4
1 1 1 1 1 8 1 1 1 1 1 1 4 4 4 4 4 4 5 5 4 4 4 4 3 3 3 0 0 0 5 5 0 0 0 2 2 2 2 2 0 0 0 0 0 0 0 0 0 4
2 5 5 1 1 8 1 1 6 6 6 6 0 0 5 5 5 5 5 5 4 4 4 3 3 3 0 0 0 0 5 5 0 0 0 0 2 2 2 2 6 6 6 0 0 0 0 0 0 4
2 5 5 1 1 8 1 1 2 2 2 2 0 0 0 5 5 5 5 5 4 4 4 3 3 0 0 0 0 0 5 5 0 0 0 0 0 0 2 2 2 2 2 0 0 0 0 0 0 4
2 5 5 1 1 8 1 1 2 2 2 2 0 0 0 0 4 4 4 4 4 3 3 3 0 0 0 0 0 0 5 5 0 0 0 0 0 0 0 2 2 2 2 6 0 0 0 0 0 4
2 5 5 1 8 8 1 1 0 0 0 0 0 0 1 1 1 1 1 1 1 4 0 0 0 0 0 0 0 4 5 5 4 0 0 0 0 0 0 0 0 2 2 2 6 6 0 0 0 4
2 3 3 3 3 8 1 1 1 0 1 1 1 1 1 8 8 8 8 8 1 4 0 0 0 4 4 4 4 4 5 5 4 4 4 4 0 0 0 0 0 0 2 2 2 2 0 0 0 4
2 5 5 1 8 3 8 8 8 8 8 8 8 8 8 8 8 8 8 8 1 4 0 0 4 4 4 4 4 4 5 5 4 4 4 4 4 4 0 0 0 0 2 2 2 2 0 0 0 4
2 5 3 1 3 3 8 8 8 8 8 8 8 8 8 8 8 8 8 8 1 4 0 4 4 4 4 4 4 4 5 5 4 4 4 4 4 4 4 0 0 0 2 2 2 2 0 0 0 1
2 5 5 3 3 3 1 1 1 1 8 1 8 1 1 1 8 8 8 8 1 4 0 4 4 6 6 4 4 4 5 5 4 4 4 4 4 4 4 4 0 0 2 2 2 2 0 0 0 1
2 2 2 2 0 3 0 1 8 8 8 1 8 8 8 1 8 8 8 8 1 4 4 4 4 2 2 4 4 4 5 5 4 4 4 4 4 4 4 4 4 0 0 2 2 2 0 0 1 1
4 2 2 2 0 0 3 8 8 8 8 1 8 8 8 1 8 8 8 8 8 5 5 5 5 5 5 5 5 5 5 5 5 5 5 5 5 5 5 3 5 3 3 2 2 2 3 3 3 3
4 2 2 2 0 3 3 8 8 8 8 1 8 8 8 1 8 8 8 8 8 5 5 5 5 5 5 5 5 5 5 5 5 5 5 5 5 3 3 3 3 5 3 2 2 2 3 3 3 3
4 2 2 2 0 0 3 1 8 8 3 1 3 8 8 1 8 8 8 8 1 4 4 6 6 2 2 4 4 4 5 5 4 4 4 4 4 4 4 4 4 4 0 2 2 2 0 0 1 1
4 2 2 2 0 0 0 1 1 1 3 3 1 1 3 1 1 1 1 1 1 0 6 2 2 2 2 4 4 4 5 5 4 4 4 4 4 4 4 0 0 6 6 2 2 2 6 0 0 1
4 2 2 2 6 6 6 6 6 6 6 6 6 6 6 6 6 6 6 6 6 6 2 2 2 2 4 4 4 4 5 5 4 4 4 4 4 4 0 0 6 2 2 2 2 2 2 6 0 1
4 2 2 2 2 2 2 2 2 2 2 2 2 2 2 2 2 2 2 2 2 2 2 2 2 2 4 4 4 4 5 5 4 4 4 4 4 0 6 6 2 2 2 2 2 0 2 2 6 6
4 4 4 4 0 0 0 0 0 0 0 0 0 0 0 0 0 0 0 0 0 0 0 0 0 4 4 4 4 4 5 5 0 4 4 0 0 6 2 2 2 2 2 2 6 0 2 2 2 2
4 4 4 4 0 0 0 0 0 0 0 0 0 0 0 0 0 0 0 0 0 0 0 0 0 0 0 0 0 0 0 0 0 0 0 0 6 2 2 2 2 2 2 2 2 6 6 2 2 2
4 4 4 0 0 0 0 0 0 0 0 0 0 0 0 0 0 0 0 0 0 0 0 0 0 0 4 4 4 4 0 5 4 4 4 4 2 2 2 2 2 2 2 2 2 2 2 2 2 2
4 4 4 4 0 0 4 4 4 4 4 4 4 4 4 4 4 4 4 4 4 4 4 4 4 4 4 4 4 4 5 5 0 4 0 0 2 2 2 2 2 2 2 2 2 2 2 2 2 2
4 4 4 0 0 4 4 4 4 4 4 4 4 4 4 4 4 4 4 4 4 4 4 4 4 4 0 4 0 0 0 0 0 0 0 0 2 2 2 2 2 2 2 2 2 2 2 2 2 2
4 4 0 0 0 4 4 4 4 4 4 4 4 4 4 4 4 4 4 4 4 4 4 4 4 4 4 4 4 4 0 5 4 4 4 4 2 2 2 2 6 2 2 2 2 2 2 2 2 2
4 4 4 0 0 4 4 4 4 4 4 4 4 4 4 4 4 4 4 4 4 4 4 4 4 4 4 4 4 4 5 0 0 4 0 0 0 2 2 2 2 2 2 2 2 2 2 2 2 2
4 4 0 0 0 4 4 4 4 4 4 4 4 4 4 4 4 4 4 4 4 4 4 4 4 4 0 4 4 4 0 0 0 0 0 0 0 0 2 2 2 2 2 2 2 2 2 2 2 2
4 4 4 0 0 4 4 4 4 4 4 4 4 4 4 4 4 4 4 4 4 4 4 4 4 4 6 6 6 4 5 5 4 4 4 4 0 0 0 2 2 2 2 2 2 2 2 2 2 2
4 4 4 4 0 4 4 4 4 4 4 4 4 4 4 4 4 4 4 4 4 4 4 4 4 4 2 2 2 4 5 5 0 4 0 0 0 0 0 2 2 2 2 2 2 2 2 2 2 2
4 4 4 0 0 4 4 4 4 4 4 4 4 4 4 4 4 4 4 4 4 4 4 4 4 4 2 2 2 0 0 0 0 0 0 0 0 0 0 0 2 2 2 2 2 2 2 2 2 2
4 4 4 3 0 4 4 4 4 4 4 4 4 4 4 4 4 4 4 4 4 4 4 4 4 4 2 2 2 0 0 0 0 0 0 0 0 0 0 0 0 2 2 2 2 2 2 2 2 2
4 4 3 3 3 4 4 4 4 4 3 0 0 0 0 0 0 0 0 4 4 4 4 4 4 4 2 2 0 0 0 0 0 0 0 0 0 4 4 4 4 2 2 2 2 2 2 2 2 2
4 4 4 4 3 0 4 4 4 4 4 3 4 4 0 0 4 0 0 4 4 4 4 4 4 4 0 0 0 0 0 0 0 0 0 0 0 4 4 4 4 0 4 0 4 0 0 0 4 4
4 4 3 3 3 3 3 3 3 3 4 3 4 4 0 0 4 0 0 4 4 4 4 4 4 4 0 0 4 0 0 0 0 0 0 0 0 4 4 0 0 4 4 4 0 4 0 4 4 4
4 4 3 3 3 3 3 3 3 3 3 3 4 4 0 0 0 0 0 4 6 6 4 4 4 4 0 4 4 4 0 0 0 0 4 0 0 0 4 4 4 4 4 4 4 4 4 4 4 4
4 4 4 3 3 3 3 3 3 3 3 3 4 4 4 4 0 4 6 6 2 2 6 6 4 4 4 4 4 4 4 4 4 4 4 0 0 0 4 4 4 4 4 4 4 4 4 4 4 4
4 4 4 3 3 3 3 3 3 3 3 4 4 4 4 4 0 4 2 2 2 2 2 2 6 4 4 4 4 4 4 4 4 4 0 0 0 0 4 4 4 4 4 4 4 4 4 4 4 4
4 4 4 4 3 3 3 3 4 4 4 4 4 4 4 4 0 4 2 6 2 2 2 2 2 6 4 4 4 4 4 4 4 4 0 5 0 0 0 0 4 0 4 4 4 4 4 4 4 4
4 4 4 4 4 3 4 4 4 4 4 4 4 4 4 4 0 4 2 2 2 2 2 2 2 2 4 4 4 4 4 4 4 0 0 4 4 4 0 0 0 4 4 4 4 4 4 4 4 4
4 4 4 4 4 4 4 4 4 4 4 4 4 4 4 4 0 4 4 4 2 2 4 4 4 4 4 4 4 4 4 4 4 0 0 5 0 4 4 0 0 0 4 4 4 4 4 4 4 4
4 4 4 4 4 4 4 4 4 4 4 4 4 4 4 4 0 4 4 4 4 4 4 4 4 4 4 4 4 4 4 4 4 0 5 5 0 4 4 0 0 0 4 4 4 4 4 4 4 4
4 4 4 4 4 4 4 4 4 4 4 4 4 4 4 4 4 4 4 4 4 4 4 4 4 4 4 4 4 4 4 4 4 1 1 1 1 4 4 4 4 4 4 4 4 4 4 4 4 4